AD	ANDORRA	ANDRR	en
AE	UNITED ARAB EMIRATES	UNTD RB MRTS	en
AF	AFGHANISTAN	AFGHNSTN	en
AG	ANTIGUA AND BARBUDA	ANTG ND BRBD	en
AI	ANGUILLA	ANGLL	en
AL	ALBANIA	ALBN	en
AM	ARMENIA	ARMN	en
AN	NETHERLANDS ANTILLES	NNTHRLNDS NTLLS	en
AO	ANGOLA	ANGL	en
AQ	ANTARCTICA	ANTRCTC	en
AR	ARGENTINA	ARGNTN	en
AS	AMERICAN SAMOA	AMRCN SM	en
AT	AUSTRIA	ASTR	en
AU	AUSTRALIA	ASTRL	en
AW	ARUBA	ARB	en
AX	ÅLAND ISLANDS	ÅLND SLNDS	en
AZ	AZERBAIJAN	AZRBJN	en
BA	BOSNIA AND HERZEGOVINA	BBSN ND HRZGVN	en
BB	BARBADOS	BBRBDS	en
BD	BANGLADESH	BBNGLDSH	en
BE	BELGIUM	BBLGM	en
BF	BURKINA FASO	BBRKN FS	en
BG	BULGARIA	BBLGR	en
BH	BAHRAIN	BBHRN	en
BI	BURUNDI	BBRND	en
BJ	BENIN	BBNN	en
BM	BERMUDA	BBRMD	en
BN	BRUNEI DARUSSALAM	BBRN DRSSLM	en
BO	BOLIVIA	BBLV	en
BR	BRAZIL	BBRZL	en
BS	BAHAMAS	BBHMS	en
BT	BHUTAN	BBHTN	en
BV	BOUVET ISLAND	BBVT SLND	en
BW	BOTSWANA	BBTSWN	en
BY	BELARUS	BBLRS	en
BZ	BELIZE	BBLZ	en
CA	CANADA	CCND	en
CC	COCOS (KEELING) ISLANDS	CCCS (KLNG) SLNDS	en
CD	CONGO, THE DEMOCRATIC REPUBLIC OF THE	CCNG, TH DMCRTC RPBLC F TH	en
CF	CENTRAL AFRICAN REPUBLIC	CCNTRL FRCN RPBLC	en
CG	CONGO	CCNG	en
CH	SWITZERLAND	SSWTZRLND	en
CI	COTE D'IVOIRE	CCT D'VR	en
CK	COOK ISLANDS	CCK SLNDS	en
CL	CHILE	CCHL	en
CM	CAMEROON	CCMRN	en
CN	CHINA	CCHN	en
CO	COLOMBIA	CCLMB	en
CR	COSTA RICA	CCST RC	en
CU	CUBA	CCB	en
CV	CAPE VERDE	CCP VRD	en
CX	CHRISTMAS ISLAND	CCHRSTMS SLND	en
CY	CYPRUS	CCYPRS	en
CZ	CZECH REPUBLIC	CCZCH RPBLC	en
DE	GERMANY	GGRMNY	en
DJ	DJIBOUTI	DDJBT	en
DK	DENMARK	DDNMRK	en
DM	DOMINICA	DDMNC	en
DO	DOMINICAN REPUBLIC	DDMNCN RPBLC	en
DZ	ALGERIA	ALGR	en
EC	ECUADOR	ECDR	en
EE	ESTONIA	ESTN	en
EG	EGYPT	EGYPT	en
EH	WESTERN SAHARA	WWSTRN SHR	en
ER	ERITREA	ERTR	en
ES	SPAIN	SSPN	en
ET	ETHIOPIA	ETHP	en
FI	FINLAND	FFNLND	en
FJ	FIJI	FFJ	en
FK	FALKLAND ISLANDS (MALVINAS)	FFLKLND SLNDS (MLVNS)	en
FM	MICRONESIA, FEDERATED STATES OF	MMCRNS, FDRTD STTS F	en
FO	FAROE ISLANDS	FFR SLNDS	en
FR	FRANCE	FFRNC	en
GA	GABON	GGBN	en
GB	UNITED KINGDOM	UNTD KNGDM	en
GD	GRENADA	GGRND	en
GE	GEORGIA	GGRG	en
GF	FRENCH GUIANA	FFRNCH GN	en
GG	GUERNSEY	GGRNSY	en
GH	GHANA	GGHN	en
GI	GIBRALTAR	GGBRLTR	en
GL	GREENLAND	GGRNLND	en
GM	GAMBIA	GGMB	en
GN	GUINEA	GGN	en
GP	GUADELOUPE	GGDLP	en
GQ	EQUATORIAL GUINEA	EQTRL GN	en
GR	GREECE	GGRC	en
GS	SOUTH GEORGIA AND THE SOUTH SANDWICH ISLANDS	SSTH GRG ND TH STH SNDWCH SLNDS	en
GT	GUATEMALA	GGTML	en
GU	GUAM	GGM	en
GW	GUINEA-BISSAU	GGN-BSS	en
GY	GUYANA	GGYN	en
HK	HONG KONG	HHNG KNG	en
HM	HEARD ISLAND AND MCDONALD ISLANDS	HHRD SLND ND MCDNLD SLNDS	en
HN	HONDURAS	HHNDRS	en
HR	CROATIA	CCRT	en
HT	HAITI	HHT	en
HU	HUNGARY	HHNGRY	en
ID	INDONESIA	INDNS	en
IE	IRELAND	IRLND	en
IL	ISRAEL	ISRL	en
IM	ISLE OF MAN	ISL F MN	en
IN	INDIA	IND	en
IO	BRITISH INDIAN OCEAN TERRITORY	BBRTSH NDN CN TRRTRY	en
IQ	IRAQ	IRQ	en
IR	IRAN, ISLAMIC REPUBLIC OF	IRN, SLMC RPBLC F	en
IS	ICELAND	ICLND	en
IT	ITALY	ITLY	en
JE	JERSEY	JJRSY	en
JM	JAMAICA	JJMC	en
JO	JORDAN	JJRDN	en
JP	JAPAN	JJPN	en
KE	KENYA	KKNY	en
KG	KYRGYZSTAN	KKYRGYZSTN	en
KH	CAMBODIA	CCMBD	en
KI	KIRIBATI	KKRBT	en
KM	COMOROS	CCMRS	en
KN	SAINT KITTS AND NEVIS	SSNT KTTS ND NVS	en
KP	KOREA, DEMOCRATIC PEOPLE'S REPUBLIC OF	KKR, DMCRTC PPL'S RPBLC F	en
KR	KOREA, REPUBLIC OF	KKR, RPBLC F	en
KW	KUWAIT	KKWT	en
KY	CAYMAN ISLANDS	CCYMN SLNDS	en
KZ	KAZAKHSTAN	KKZKHSTN	en
LA	LAO PEOPLE'S DEMOCRATIC REPUBLIC	LL PPL'S DMCRTC RPBLC	en
LB	LEBANON	LLBNN	en
LC	SAINT LUCIA	SSNT LC	en
LI	LIECHTENSTEIN	LLCHTNSTN	en
LK	SRI LANKA	SSR LNK	en
LR	LIBERIA	LLBR	en
LS	LESOTHO	LLSTH	en
LT	LITHUANIA	LLTHN	en
LU	LUXEMBOURG	LLXMBRG	en
LV	LATVIA	LLTV	en
LY	LIBYAN ARAB JAMAHIRIYA	LLBYN RB JMHRY	en
MA	MOROCCO	MMRCC	en
MC	MONACO	MMNC	en
MD	MOLDOVA, REPUBLIC OF	MMLDV, RPBLC F	en
ME	MONTENEGRO	MMNTNGR	en
MG	MADAGASCAR	MMDGSCR	en
MH	MARSHALL ISLANDS	MMRSHLL SLNDS	en
MK	MACEDONIA, THE FORMER YUGOSLAV REPUBLIC OF	MMCDN, TH FRMR YGSLV RPBLC F	en
ML	MALI	MML	en
MM	MYANMAR	MMYNMR	en
MN	MONGOLIA	MMNGL	en
MO	MACAO	MMC	en
MP	NORTHERN MARIANA ISLANDS	NNRTHRN MRN SLNDS	en
MQ	MARTINIQUE	MMRTNQ	en
MR	MAURITANIA	MMRTN	en
MS	MONTSERRAT	MMNTSRRT	en
MT	MALTA	MMLT	en
MU	MAURITIUS	MMRTS	en
MV	MALDIVES	MMLDVS	en
MW	MALAWI	MMLW	en
MX	MEXICO	MMXC	en
MY	MALAYSIA	MMLYS	en
MZ	MOZAMBIQUE	MMZMBQ	en
NA	NAMIBIA	NNMB	en
NC	NEW CALEDONIA	NNW CLDN	en
NE	NIGER	NNGR	en
NF	NORFOLK ISLAND	NNRFLK SLND	en
NG	NIGERIA	NNGR	en
NI	NICARAGUA	NNCRG	en
NL	NETHERLANDS	NNTHRLNDS	en
NO	NORWAY	NNRWY	en
NP	NEPAL	NNPL	en
NR	NAURU	NNR	en
NU	NIUE	NN	en
NZ	NEW ZEALAND	NNW ZLND	en
OM	OMAN	OMN	en
PA	PANAMA	PPNM	en
PE	PERU	PPR	en
PF	FRENCH POLYNESIA	FFRNCH PLYNS	en
PG	PAPUA NEW GUINEA	PPP NW GN	en
PH	PHILIPPINES	PPHLPPNS	en
PK	PAKISTAN	PPKSTN	en
PL	POLAND	PPLND	en
PM	SAINT PIERRE AND MIQUELON	SSNT PRR ND MQLN	en
PN	PITCAIRN	PPTCRN	en
PR	PUERTO RICO	PPRT RC	en
PS	PALESTINIAN TERRITORY, OCCUPIED	PPLSTNN TRRTRY, CCPD	en
PT	PORTUGAL	PPRTGL	en
PW	PALAU	PPL	en
PY	PARAGUAY	PPRGY	en
QA	QATAR	QQTR	en
RE	REUNION	RRNN	en
RO	ROMANIA	RRMN	en
RS	SERBIA	SSRB	en
RU	RUSSIAN FEDERATION	RRSSN FDRTN	en
RW	RWANDA	RRWND	en
SA	SAUDI ARABIA	SSD RB	en
SB	SOLOMON ISLANDS	SSLMN SLNDS	en
SC	SEYCHELLES	SSYCHLLS	en
SD	SUDAN	SSDN	en
SE	SWEDEN	SSWDN	en
SG	SINGAPORE	SSNGPR	en
SH	SAINT HELENA	SSNT HLN	en
SI	SLOVENIA	SSLVN	en
SJ	SVALBARD AND JAN MAYEN	SSVLBRD ND JN MYN	en
SK	SLOVAKIA	SSLVK	en
SL	SIERRA LEONE	SSRR LN	en
SM	SAN MARINO	SSN MRN	en
SN	SENEGAL	SSNGL	en
SO	SOMALIA	SSML	en
SR	SURINAME	SSRNM	en
ST	SAO TOME AND PRINCIPE	SS TM ND PRNCP	en
SV	EL SALVADOR	EL SLVDR	en
SY	SYRIAN ARAB REPUBLIC	SSYRN RB RPBLC	en
SZ	SWAZILAND	SSWZLND	en
TC	TURKS AND CAICOS ISLANDS	TTRKS ND CCS SLNDS	en
TD	CHAD	CCHD	en
TF	FRENCH SOUTHERN TERRITORIES	FFRNCH STHRN TRRTRS	en
TG	TOGO	TTG	en
TH	THAILAND	TTHLND	en
TJ	TAJIKISTAN	TTJKSTN	en
TK	TOKELAU	TTKL	en
TL	TIMOR-LESTE	TTMR-LST	en
TM	TURKMENISTAN	TTRKMNSTN	en
TN	TUNISIA	TTNS	en
TO	TONGA	TTNG	en
TR	TURKEY	TTRKY	en
TT	TRINIDAD AND TOBAGO	TTRNDD ND TBG	en
TV	TUVALU	TTVL	en
TW	CHINESE TAIPEI	TTWN, PRVNC F CHN	en
TZ	TANZANIA, UNITED REPUBLIC OF	TTNZN, NTD RPBLC F	en
UA	UKRAINE	UKRN	en
UG	UGANDA	UGND	en
UM	UNITED STATES MINOR OUTLYING ISLANDS	UNTD STTS MNR TLYNG SLNDS	en
US	UNITED STATES	UNTD STTS	en
UY	URUGUAY	URGY	en
UZ	UZBEKISTAN	UZBKSTN	en
VA	HOLY SEE (VATICAN CITY STATE)	HHLY S (VTCN CTY STT)	en
VC	SAINT VINCENT AND THE GRENADINES	SSNT VNCNT ND TH GRNDNS	en
VE	VENEZUELA	VVNZL	en
VG	VIRGIN ISLANDS, BRITISH	VVRGN SLNDS, BRTSH	en
VI	VIRGIN ISLANDS, U.S.	VVRGN SLNDS, .S.	en
VN	VIET NAM	VVT NM	en
VU	VANUATU	VVNT	en
WF	WALLIS AND FUTUNA	WWLLS ND FTN	en
WS	SAMOA	SSM	en
YE	YEMEN	YYMN	en
YT	MAYOTTE	MMYTT	en
ZA	SOUTH AFRICA	SSTH FRC	en
ZM	ZAMBIA	ZZMB	en
ZW	ZIMBABWE	ZZMBBW	en