AD	ANDORRE	ANDRR	fr
AE	ÉMIRATS ARABES UNIS	ÉÉMRTS RBS NS	fr
AF	AFGHANISTAN	AFGHNSTN	fr
AG	ANTIGUA-ET-BARBUDA	ANTG-T-BRBD	fr
AI	ANGUILLA	ANGLL	fr
AL	ALBANIE	ALBN	fr
AM	ARMÉNIE	ARMÉN	fr
AN	ANTILLES NÉERLANDAISES	ANTLLS NÉRLNDSS	fr
AO	ANGOLA	ANGL	fr
AQ	ANTARCTIQUE	ANTRCTQ	fr
AR	ARGENTINE	ARGNTN	fr
AS	SAMOA AMÉRICAINES	SSM MÉRCNS	fr
AT	AUTRICHE	ATRCH	fr
AU	AUSTRALIE	ASTRL	fr
AW	ARUBA	ARB	fr
AX	ÅLAND, ÎLES	ÅÅLND, ÎLS	fr
AZ	AZERBAÏDJAN	AZRBÏDJN	fr
BA	BOSNIE-HERZÉGOVINE	BBSN-HRZÉGVN	fr
BB	BARBADE	BBRBD	fr
BD	BANGLADESH	BBNGLDSH	fr
BE	BELGIQUE	BBLGQ	fr
BF	BURKINA FASO	BBRKN FS	fr
BG	BULGARIE	BBLGR	fr
BH	BAHREÏN	BBHRÏN	fr
BI	BURUNDI	BBRND	fr
BJ	BÉNIN	BBÉNN	fr
BM	BERMUDES	BBRMDS	fr
BN	BRUNÉI DARUSSALAM	BBRNÉ DRSSLM	fr
BO	BOLIVIE	BBLV	fr
BR	BRÉSIL	BBRÉSL	fr
BS	BAHAMAS	BBHMS	fr
BT	BHOUTAN	BBHTN	fr
BV	BOUVET, ÎLE	BBVT, ÎL	fr
BW	BOTSWANA	BBTSWN	fr
BY	BÉLARUS	BBÉLRS	fr
BZ	BELIZE	BBLZ	fr
CA	CANADA	CCND	fr
CC	COCOS (KEELING), ÎLES	CCCS (KLNG), ÎLS	fr
CD	CONGO, LA RÉPUBLIQUE DÉMOCRATIQUE DU	CCNG, L RÉPBLQ DÉMCRTQ D	fr
CF	CENTRAFRICAINE, RÉPUBLIQUE	CCNTRFRCN, RÉPBLQ	fr
CG	CONGO	CCNG	fr
CH	SUISSE	SSSS	fr
CI	CÔTE D'IVOIRE	CCÔT D'VR	fr
CK	COOK, ÎLES	CCK, ÎLS	fr
CL	CHILI	CCHL	fr
CM	CAMEROUN	CCMRN	fr
CN	CHINE	CCHN	fr
CO	COLOMBIE	CCLMB	fr
CR	COSTA RICA	CCST RC	fr
CU	CUBA	CCB	fr
CV	CAP-VERT	CCP-VRT	fr
CX	CHRISTMAS, ÎLE	CCHRSTMS, ÎL	fr
CY	CHYPRE	CCHYPR	fr
CZ	TCHÈQUE, RÉPUBLIQUE	TTCHÈQ, RÉPBLQ	fr
DE	ALLEMAGNE	ALLMGN	fr
DJ	DJIBOUTI	DDJBT	fr
DK	DANEMARK	DDNMRK	fr
DM	DOMINIQUE	DDMNQ	fr
DO	DOMINICAINE, RÉPUBLIQUE	DDMNCN, RÉPBLQ	fr
DZ	ALGÉRIE	ALGÉR	fr
EC	ÉQUATEUR	ÉÉQTR	fr
EE	ESTONIE	ESTN	fr
EG	ÉGYPTE	ÉÉGYPT	fr
EH	SAHARA OCCIDENTAL	SSHR CCDNTL	fr
ER	ÉRYTHRÉE	ÉÉRYTHRÉ	fr
ES	ESPAGNE	ESPGN	fr
ET	ÉTHIOPIE	ÉÉTHP	fr
FI	FINLANDE	FFNLND	fr
FJ	FIDJI	FFDJ	fr
FK	FALKLAND, ÎLES (MALVINAS)	FFLKLND, ÎLS (MLVNS)	fr
FM	MICRONÉSIE, ÉTATS FÉDÉRÉS DE	MMCRNÉS, ÉTTS FÉDÉRÉS D	fr
FO	FÉROÉ, ÎLES	FFÉRÉ, ÎLS	fr
FR	FRANCE	FFRNC	fr
GA	GABON	GGBN	fr
GB	ROYAUME-UNI	RRYM-N	fr
GD	GRENADE	GGRND	fr
GE	GÉORGIE	GGÉRG	fr
GF	GUYANE FRANÇAISE	GGYN FRNÇS	fr
GG	GUERNESEY	GGRNSY	fr
GH	GHANA	GGHN	fr
GI	GIBRALTAR	GGBRLTR	fr
GL	GROENLAND	GGRNLND	fr
GM	GAMBIE	GGMB	fr
GN	GUINÉE	GGNÉ	fr
GP	GUADELOUPE	GGDLP	fr
GQ	GUINÉE ÉQUATORIALE	GGNÉ ÉQTRL	fr
GR	GRÈCE	GGRÈC	fr
GS	GÉORGIE DU SUD ET LES ÎLES SANDWICH DU SUD	GGÉRG D SD T LS ÎLS SNDWCH D SD	fr
GT	GUATEMALA	GGTML	fr
GU	GUAM	GGM	fr
GW	GUINÉE-BISSAU	GGNÉ-BSS	fr
GY	GUYANA	GGYN	fr
HK	HONG-KONG	HHNG-KNG	fr
HM	HEARD, ÎLE ET MCDONALD, ÎLES	HHRD, ÎL T MCDNLD, ÎLS	fr
HN	HONDURAS	HHNDRS	fr
HR	CROATIE	CCRT	fr
HT	HAÏTI	HHÏT	fr
HU	HONGRIE	HHNGR	fr
ID	INDONÉSIE	INDNÉS	fr
IE	IRLANDE	IRLND	fr
IL	ISRAËL	ISRËL	fr
IM	ÎLE DE MAN	ÎÎL D MN	fr
IN	INDE	IND	fr
IO	OCÉAN INDIEN, TERRITOIRE BRITANNIQUE DE L'	OCÉN NDN, TRRTR BRTNNQ D L'	fr
IQ	IRAQ	IRQ	fr
IR	IRAN, RÉPUBLIQUE ISLAMIQUE D'	IRN, RÉPBLQ SLMQ D'	fr
IS	ISLANDE	ISLND	fr
IT	ITALIE	ITL	fr
JE	JERSEY	JJRSY	fr
JM	JAMAÏQUE	JJMÏQ	fr
JO	JORDANIE	JJRDN	fr
JP	JAPON	JJPN	fr
KE	KENYA	KKNY	fr
KG	KIRGHIZISTAN	KKRGHZSTN	fr
KH	CAMBODGE	CCMBDG	fr
KI	KIRIBATI	KKRBT	fr
KM	COMORES	CCMRS	fr
KN	SAINT-KITTS-ET-NEVIS	SSNT-KTTS-T-NVS	fr
KP	CORÉE, RÉPUBLIQUE POPULAIRE DÉMOCRATIQUE DE	CCRÉ, RÉPBLQ PPLR DÉMCRTQ D	fr
KR	CORÉE, RÉPUBLIQUE DE	CCRÉ, RÉPBLQ D	fr
KW	KOWEÏT	KKWÏT	fr
KY	CAÏMANES, ÎLES	CCÏMNS, ÎLS	fr
KZ	KAZAKHSTAN	KKZKHSTN	fr
LA	LAO, RÉPUBLIQUE DÉMOCRATIQUE POPULAIRE	LL, RÉPBLQ DÉMCRTQ PPLR	fr
LB	LIBAN	LLBN	fr
LC	SAINTE-LUCIE	SSNT-LC	fr
LI	LIECHTENSTEIN	LLCHTNSTN	fr
LK	SRI LANKA	SSR LNK	fr
LR	LIBÉRIA	LLBÉR	fr
LS	LESOTHO	LLSTH	fr
LT	LITUANIE	LLTN	fr
LU	LUXEMBOURG	LLXMBRG	fr
LV	LETTONIE	LLTTN	fr
LY	LIBYENNE, JAMAHIRIYA ARABE	LLBYNN, JMHRY RB	fr
MA	MAROC	MMRC	fr
MC	MONACO	MMNC	fr
MD	MOLDOVA, RÉPUBLIQUE DE	MMLDV, RÉPBLQ D	fr
ME	MONTÉNÉGRO	MMNTÉNÉGR	fr
MG	MADAGASCAR	MMDGSCR	fr
MH	MARSHALL, ÎLES	MMRSHLL, ÎLS	fr
MK	MACÉDOINE, L'EX-RÉPUBLIQUE YOUGOSLAVE DE	MMCÉDN, L'X-RÉPBLQ YGSLV D	fr
ML	MALI	MML	fr
MM	MYANMAR	MMYNMR	fr
MN	MONGOLIE	MMNGL	fr
MO	MACAO	MMC	fr
MP	MARIANNES DU NORD, ÎLES	MMRNNS D NRD, ÎLS	fr
MQ	MARTINIQUE	MMRTNQ	fr
MR	MAURITANIE	MMRTN	fr
MS	MONTSERRAT	MMNTSRRT	fr
MT	MALTE	MMLT	fr
MU	MAURICE	MMRC	fr
MV	MALDIVES	MMLDVS	fr
MW	MALAWI	MMLW	fr
MX	MEXIQUE	MMXQ	fr
MY	MALAISIE	MMLS	fr
MZ	MOZAMBIQUE	MMZMBQ	fr
NA	NAMIBIE	NNMB	fr
NC	NOUVELLE-CALÉDONIE	NNVLL-CLÉDN	fr
NE	NIGER	NNGR	fr
NF	NORFOLK, ÎLE	NNRFLK, ÎL	fr
NG	NIGÉRIA	NNGÉR	fr
NI	NICARAGUA	NNCRG	fr
NL	PAYS-BAS	PPYS-BS	fr
NO	NORVÈGE	NNRVÈG	fr
NP	NÉPAL	NNÉPL	fr
NR	NAURU	NNR	fr
NU	NIUÉ	NNÉ	fr
NZ	NOUVELLE-ZÉLANDE	NNVLL-ZÉLND	fr
OM	OMAN	OMN	fr
PA	PANAMA	PPNM	fr
PE	PÉROU	PPÉR	fr
PF	POLYNÉSIE FRANÇAISE	PPLYNÉS FRNÇS	fr
PG	PAPOUASIE-NOUVELLE-GUINÉE	PPPS-NVLL-GNÉ	fr
PH	PHILIPPINES	PPHLPPNS	fr
PK	PAKISTAN	PPKSTN	fr
PL	POLOGNE	PPLGN	fr
PM	SAINT-PIERRE-ET-MIQUELON	SSNT-PRR-T-MQLN	fr
PN	PITCAIRN	PPTCRN	fr
PR	PORTO RICO	PPRT RC	fr
PS	PALESTINIEN OCCUPÉ, TERRITOIRE	PPLSTNN CCPÉ, TRRTR	fr
PT	PORTUGAL	PPRTGL	fr
PW	PALAOS	PPLS	fr
PY	PARAGUAY	PPRGY	fr
QA	QATAR	QQTR	fr
RE	RÉUNION	RRÉNN	fr
RO	ROUMANIE	RRMN	fr
RS	SERBIE	SSRB	fr
RU	RUSSIE, FÉDÉRATION DE	RRSS, FÉDÉRTN D	fr
RW	RWANDA	RRWND	fr
SA	ARABIE SAOUDITE	ARB SDT	fr
SB	SALOMON, ÎLES	SSLMN, ÎLS	fr
SC	SEYCHELLES	SSYCHLLS	fr
SD	SOUDAN	SSDN	fr
SE	SUÈDE	SSÈD	fr
SG	SINGAPOUR	SSNGPR	fr
SH	SAINTE-HÉLÈNE	SSNT-HÉLÈN	fr
SI	SLOVÉNIE	SSLVÉN	fr
SJ	SVALBARD ET ÎLE JAN MAYEN	SSVLBRD T ÎL JN MYN	fr
SK	SLOVAQUIE	SSLVQ	fr
SL	SIERRA LEONE	SSRR LN	fr
SM	SAINT-MARIN	SSNT-MRN	fr
SN	SÉNÉGAL	SSÉNÉGL	fr
SO	SOMALIE	SSML	fr
SR	SURINAME	SSRNM	fr
ST	SAO TOMÉ-ET-PRINCIPE	SS TMÉ-T-PRNCP	fr
SV	EL SALVADOR	EL SLVDR	fr
SY	SYRIENNE, RÉPUBLIQUE ARABE	SSYRNN, RÉPBLQ RB	fr
SZ	SWAZILAND	SSWZLND	fr
TC	TURKS ET CAÏQUES, ÎLES	TTRKS T CÏQS, ÎLS	fr
TD	TCHAD	TTCHD	fr
TF	TERRES AUSTRALES FRANÇAISES	TTRRS STRLS FRNÇSS	fr
TG	TOGO	TTG	fr
TH	THAÏLANDE	TTHÏLND	fr
TJ	TADJIKISTAN	TTDJKSTN	fr
TK	TOKELAU	TTKL	fr
TL	TIMOR-LESTE	TTMR-LST	fr
TM	TURKMÉNISTAN	TTRKMÉNSTN	fr
TN	TUNISIE	TTNS	fr
TO	TONGA	TTNG	fr
TR	TURQUIE	TTRQ	fr
TT	TRINITÉ-ET-TOBAGO	TTRNTÉ-T-TBG	fr
TV	TUVALU	TTVL	fr
TW	TAÏWAN, PROVINCE DE CHINE	TTÏWN, PRVNC D CHN	fr
TZ	TANZANIE, RÉPUBLIQUE-UNIE DE	TTNZN, RÉPBLQ-N D	fr
UA	UKRAINE	UKRN	fr
UG	OUGANDA	OGND	fr
UM	ÎLES MINEURES ÉLOIGNÉES DES ÉTATS-UNIS	ÎÎLS MNRS ÉLGNÉS DS ÉTTS-NS	fr
US	ÉTATS-UNIS	ÉÉTTS-NS	fr
UY	URUGUAY	URGY	fr
UZ	OUZBÉKISTAN	OZBÉKSTN	fr
VA	SAINT-SIÈGE (ÉTAT DE LA CITÉ DU VATICAN)	SSNT-SÈG (ÉTT D L CTÉ D VTCN)	fr
VC	SAINT-VINCENT-ET-LES GRENADINES	SSNT-VNCNT-T-LS GRNDNS	fr
VE	VENEZUELA	VVNZL	fr
VG	ÎLES VIERGES BRITANNIQUES	ÎÎLS VRGS BRTNNQS	fr
VI	ÎLES VIERGES DES ÉTATS-UNIS	ÎÎLS VRGS DS ÉTTS-NS	fr
VN	VIET NAM	VVT NM	fr
VU	VANUATU	VVNT	fr
WF	WALLIS ET FUTUNA	WWLLS T FTN	fr
WS	SAMOA	SSM	fr
YE	YÉMEN	YYÉMN	fr
YT	MAYOTTE	MMYTT	fr
ZA	AFRIQUE DU SUD	AFRQ D SD	fr
ZM	ZAMBIE	ZZMB	fr
ZW	ZIMBABWE	ZZMBBW	fr